border_size=1
usage=map

Gg          , Re          , Re          , Gg          , Gg          , Gs^Fds      , Gs^Fds      , Hh          , Hh          , Hh          , Gs^Fds      , Hh          , Hh          , Mm          , Mm          , Mm          , Hh          , Hh          , Gs^Fds      , Gs^Fds      , Gg          , Gg          , Gg          , Gg          , Rp          , Gg          , Gg          , Gg          , Rp          , Rp          , Ww          , Gg          
Gs^Fds      , Gs^Fds      , Gs^Fds      , Re          , Re          , Gs^Fds      , Gs^Fds      , Hh          , Hh          , Hh          , Gs^Fds      , Gs^Fds      , Hh          , Gs^Fds      , Mm          , Mm          , Hh          , Hh          , Gs^Fds      , Gs^Fds      , Gg          , Gg          , Gg^Ve       , Rp          , Chr         , Chr         , Chr         , 2 Khr       , Ww          , Ww          , Ww          , Ww          
Hh          , Hh          , Hh          , Gs^Fds      , Gg^Ve       , Re          , Gs^Fds      , Gs^Fds      , Gs^Fds      , Gs^Fds      , Gg          , Gg          , Gs^Fds      , Hh          , Hh          , Hh          , Gs^Fds      , Gs^Fds      , Gs^Fds      , Gs^Fds      , Gg          , Gg          , Gg          , Rp          , Chr         , Rp          , Chr         , Chr         , Ww          , Ww          , Ww          , Ww          
Mm          , Hh          , Hh          , Gs^Fds      , Ce          , Ce          , Ce          , Gs^Fds      , Gs^Fds      , Gs^Fds      , Gg          , Gg          , Gs^Fds      , Hh          , Hh          , Gs^Fds      , Gs^Fds      , Gs^Fds      , Hh          , Gg          , Gg          , Gg          , Rp          , Rp          , Gg          , Rp          , Ww          , Wwf         , Wwf         , Ww          , Gg^Ve       , Ww          
Mm          , Mm          , Hh          , Gs^Fds      , Ce          , 1 Ke        , Ce          , Gs^Fds      , Gs^Fds      , Gs^Fds      , Gg          , Gg^Ve       , Gg          , Hh          , Gs^Fds      , Gs^Fds      , Gs^Fds      , Gs^Fds      , Gg          , Gg          , Rp          , Gg          , Gg          , Gg          , Ww          , Ww          , Ww^Vm       , Ww          , Ww          , Wwf         , Gg          , Gg          
Mm          , Mm          , Mm          , Hh          , Gs^Fds      , Ce          , Re          , Gs^Fds      , Gs^Fds      , Gs^Fds      , Gg          , Gg          , Gg          , Gg          , Gs^Fds      , Gs^Fds      , Gs^Fds      , Gs^Fds      , Gg          , Rp          , Gs^Fds      , Gs^Fds      , Gg          , Gg          , Ww          , Ww          , Wo          , Ww          , Ds          , Gg          , Gg          , Gg          
Mm          , Mm          , Mm          , Hh          , Gs^Fds      , Gs^Fds      , Gg          , Re          , Re          , Hh          , Gg          , Gg          , Gg          , Gg          , Gg          , Gs^Fds      , Rp          , Gg          , Hh          , Gs^Fds      , Gs^Fds      , Gs^Fds      , Ds          , Ds          , Ds          , Ww          , Ww          , Ww          , Ww          , Gg          , Gs^Fds      , Gs^Fds      
Mm          , Mm          , Mm          , Hh          , Hh          , Gs^Fds      , Gg          , Gg          , Gg          , Re          , Re          , Re          , Re          , Gg          , Gg          , Gg          , Gg          , Gg          , Gg          , Hh          , Ds          , Ds          , Ds          , Ds          , Ds          , Ds          , Ww          , Ww          , Ww          , Gg          , Gs^Fds      , Gs^Fds      
Mm          , Mm          , Hh          , Hh          , Gs^Fds      , Gs^Fds      , Gg          , Gg          , Gg          , Gg          , Gs^Fds      , Gs^Fds      , Gs^Fds      , Re          , Re          , Gg          , Hh          , Gg          , Gg          , Gg          , Ds          , Dd^Vdt      , Ds          , Ds          , Gs^Ft       , Gs^Ft       , Ww          , Ww          , Ww          , Gg          , Gg          , Gs^Fds      
Mm          , Mm          , Hh          , Hh          , Gs^Fds      , Gg^Ve       , Gg          , Gg          , Gg          , Gg          , Gs^Fds      , Gs^Fds      , Gs^Fds      , Gg^Ve       , Gg          , Re          , Re          , Hh          , Hh          , Gg          , Gg          , Gg          , Gg          , Gg          , Ww          , Ww          , Ww          , Ww          , Ww          , Gg          , Gg          , Gg          
Mm          , Mm          , Hh          , Hh          , Gs^Fds      , Gg          , Gg          , Gg          , Gs^Fds      , Gg          , Gs^Fds      , Gs^Fds      , Gg          , Gg          , Gg          , Hh          , Re          , Hh          , Gs^Fds      , Gg          , Gg          , Gg          , Gg          , Gg          , Ww          , Ww          , Ww          , Ww          , Ww          , Gg          , Gg          , Gg          
Hh          , Mm          , Hh          , Gs^Fds      , Gs^Fds      , Gs^Fds      , Gs^Fds      , Gs^Fds      , Gs^Fds      , Gs^Fds      , Gs^Fds      , Gs^Fds      , Gs^Fds      , Gg          , Gg          , Gg          , Gg          , Re          , Re          , Gg          , Gg          , Gg          , Ww          , Ww          , Ww          , Ww          , Mm^Vhh      , Ww          , Gg          , Gg          , Gg          , Gg          
Wo          , Hh          , Ss          , Ss          , Gs^Fds      , Gs^Fds      , Gs^Fds      , Hh          , Gs^Fds      , Gs^Fds      , Gs^Fds      , Gs^Fds      , Gs^Fds      , Gs^Fds      , Gs^Fds      , Gg          , Gg          , Gg          , Ww          , Re          , Ww          , Ww          , Ww          , Ww          , Ww          , Ww          , Gg          , Gg          , Gg          , Hh          , Gg          , Gg          
Wo          , Wo          , Ww          , Gs^Fds      , Gs^Fds      , Gs^Fds      , Ww          , Hh^Vhh      , Ww          , Gs^Fds      , Ww          , Ds          , Gs^Fds      , Ss          , Ww          , Ww          , Ww          , Ww          , Ww          , Ww^Bw|      , Ww          , Ww          , Ww          , Ww          , Gg          , Gg          , Hh          , Gg          , Gg          , Gg          , Gg          , Gg          
Wo          , Wo          , Ww          , Wwf         , Wwf         , Ww          , Ww          , Ww          , Ww          , Wwf         , Wwf         , Ww          , Wwf         , Ww          , Ww          , Ww          , Ww          , Ww          , Ds          , Ww^Bw|      , Ds          , Ww          , Gg          , Gg          , Gg          , Gg          , Gg          , Gg          , Gg          , Gg          , Gs^Fds      , Gs^Fds      
Wo          , Wo          , Ww          , Wwf         , Ww          , Ww          , Ww          , Ww          , Ww          , Ww          , Ww          , Wwf         , Ww          , Ww          , Ww          , Ww          , Gg          , Gg          , Gg          , Re          , Gg          , Gg          , Gg          , Gg          , Gg          , Gg          , Gg          , Gg          , Gg          , Gg^Ve       , Gs^Fds      , Gs^Fds      
Ww          , Ww          , Gg          , Wwf         , Gg          , Ww          , Gg          , Ww          , Ds          , Ww          , Ds          , Gg          , Gg          , Ds          , Gg          , Gg          , Gg          , Gs^Fds      , Gg          , Re          , Gg          , Gg          , Gs^Fds      , Gs^Fds      , Gs^Fds      , Gs^Fds      , Gs^Fds      , Gs^Fds      , Gs^Fds      , Gs^Fds      , Gs^Fds      , Gs^Fds      
Hh^Fp       , Ds          , Gg          , Gg          , Gg          , Gg          , Gg          , Gg          , Gg          , Gg          , Gg          , Gg          , Gg          , Gg          , Gg          , Gg          , Gg          , Gg          , Gg          , Re          , Re          , Gg          , Gs^Fds      , Gs^Fds      , Gs^Fds      , Gs^Fds      , Gs^Fds      , Gs^Fds      , Gs^Fds      , Gs^Fds      , Gs^Fds      , Gs^Fds      
Hh^Fp       , Hh          , Ce          , Ce          , Ce          , Gg^Ve       , Hh          , Hh^Fp       , Hh          , Gg          , Hh          , Gg          , Hh          , Gg          , Gg^Ve       , Gg          , Gs^Fds      , Gg          , Gg          , Re          , Re          , Gg          , Gs^Fds      , Gs^Fds      , Gs^Fds      , Gs^Fds      , Gs^Fds      , Gs^Fds      , Gs^Fds      , Gs^Fds      , Gs^Fds      , Gs^Fds      
Mm          , Mm          , Ce          , 3 Ke        , Ce          , Hh          , Mm          , Hh          , Hh          , Hh          , Hh          , Hh          , Hh          , Hh          , Hh          , Hh          , Hh          , Hh          , Hh          , Gg          , Re          , Gg          , Gs^Fds      , Gs^Fds      , Gs^Fds      , Gs^Fds      , Gg^Ve       , Gs^Fds      , Gs^Fds      , Gs^Fds      , Gs^Fds      , Gs^Fds      
Mm          , Mm          , Mm          , Mm          , Mm          , Mm          , Mm          , Mm          , Mm          , Mm^Vhh      , Mm          , Mm          , Mm          , Mm          , Mm          , Hh^Fp       , Mm          , Hh          , Hh          , Gg          , Re          , Gs^Fds      , Gs^Fds      , Gs^Fds      , Gs^Fds      , Gs^Fds      , Gs^Fds      , Gs^Fds      , Gs^Fds      , Gs^Fds      , Gs^Fds      , Gs^Fds      
Mm          , Mm          , Mm          , Mm          , Mm          , Mm          , Mm          , Mm          , Mm          , Mm          , Mm          , Mm          , Mm          , Hh^Fp       , Mm          , Mm          , Mm          , Hh          , Hh          , Hh          , Re          , Gs^Fds      , Gs^Fds      , Gs^Fds      , Gs^Fds      , Gs^Fds      , Gs^Fds      , Gs^Fds      , Gs^Fds      , Gs^Fds      , Gs^Fds      , Gs^Fds      
