border_size=1
usage=map

Gg          , Gg          , Gg          , Aa          , Aa          , Aa          , Aa^Fpa      , Aa^Fpa      , Aa^Fpa      , Ms          , Ms          , Ms          , Ms          , Ms          , Ms          , Ha          , Aa^Fpa      , Aa^Fpa      , Aa^Fpa      , Aa^Fpa      , Aa^Fpa      , Aa^Fpa      , Aa^Fpa      , Aa^Fpa      , Aa^Fpa      , Aa^Fpa      , Aa^Fpa      , Aa^Fpa      , Aa^Fpa      , Aa^Fpa      , Aa^Fpa      , Aa^Fpa      
Gg          , Gg          , Gg          , Aa          , Ha          , Aa          , Aa          , Aa^Fpa      , Aa^Fpa      , Aa^Fpa      , Ha          , Ms          , Ms          , Ms          , Ha          , Ha          , Aa^Fpa      , Aa^Fpa      , Aa^Fpa      , Aa^Fpa      , Aa^Fpa      , Aa^Fpa      , Aa^Fpa      , Aa^Fpa      , Aa^Fpa      , Aa^Fpa      , Aa^Fpa      , Aa^Fpa      , Aa^Fpa      , Aa^Fpa      , Aa^Fpa      , Aa^Fpa      
Gg          , Gg          , Gg          , Ha          , Ha          , Ha          , Aa          , Aa          , Aa^Fpa      , Aa^Fpa      , Ha          , Ms^Vhha     , Ms          , Ms          , Ms          , Ha          , Ha          , Aa^Fpa      , Aa          , Aa^Fpa      , Aa          , Aa^Fpa      , Aa^Fpa      , Aa^Fpa      , Ms          , Aa^Fpa      , Aa^Fpa      , Aa^Fpa      , Aa^Fpa      , Aa^Fpa      , Aa^Fpa      , Aa^Fpa      
Gg          , Gg          , Gg          , Gg          , Gg          , Aa          , Aa          , Aa          , Aa^Fpa      , Aa^Fpa      , Aa^Fpa      , Ms          , Ms          , Ms          , Ms          , Ms          , Ha          , Aa          , Aa          , Aa          , Aa          , Aa          , Ha          , Ms          , Ms          , Ms          , Ms          , Ha          , Ha          , Ha          , Ha          , Ha          
Gg          , Gg          , Gg          , Gg          , Gg          , Gg          , Gg          , Aa          , Aa^Fpa      , Aa^Fpa      , Aa^Fpa      , Ms          , Aa^Fpa      , Ms          , Ha          , Ha          , Aa          , Aa          , Aa          , Aa          , Aa          , Aa          , Aa          , Ha          , Ha          , Ms          , Ms          , Ms          , Ms          , Ms          , Ha          , Ha          
Gg          , Gg          , Gg          , Gg          , Gg          , Gg          , Gg          , Gg          , Gs^Fp       , Aa^Fpa      , Gs^Fp       , Hh          , Mm          , Mm          , Mm          , Hh          , Hh          , Aa          , Aa          , Aa          , Aa          , Aa          , Aa          , Aa          , Ha          , Ha          , Ms^Vhha     , Ms          , Ms          , Ms          , Aa^Fpa      , Aa^Fpa      
Gg          , Ggf         , Gg          , Gg          , Gg          , Gg          , Ggf         , Gg          , Gs^Fp       , Rd          , Rd          , Gs^Fp       , Gs^Fp       , Mm          , Mm          , Mm          , Mm          , Ggf         , Ggf         , Aa          , Aa          , Aa          , Aa          , Aa          , Mm          , Mm          , Mm          , Ha          , Aa^Fpa      , Aa^Fpa      , Aa          , Aa^Fpa      
Gg          , Gg          , Gg          , Gg          , Gg          , Gg          , Gs^Fp       , Gs^Fp       , Gs^Fp       , Gs^Fp       , Gs^Fp       , Gs^Fp       , Hh          , Gs^Fp       , Hh^Fp       , Mm          , Mm          , Gs^Fp       , Ch          , Rd          , Ch          , Aa          , Mm          , Mm          , Mm          , Mm          , Aa^Fpa      , Aa^Fpa      , Aa          , Aa          , Aa          , Aa^Fpa      
Gg          , Gg          , Gg          , Gg          , Gg          , Gg          , Gs^Fp       , Gs^Fp       , Gs^Fp       , Mm^Vhh      , Mm          , Hh          , Mm          , Mm          , Mm          , Hh^Fp       , Hh          , Mm          , Mm          , Rd          , Mm          , Mm          , Mm          , Mm          , Mm          , Aa^Fpa      , Rd          , Aa^Fpa      , Ha          , Aa          , Aa^Fpa      , Ha          
Gg          , Gg          , Gg          , Gg          , Gg          , Gg          , Gs^Fp       , Gs^Fp       , Mm          , Mm          , Mm          , Mm          , Ch          , 4 Kh        , Ch          , Mm          , Mm          , Hh          , Rd          , Rd          , Mm          , Mm          , Mm          , Mm          , Mm          , Gs^Fp       , Hh          , Ha          , Aa^Fpa      , Ha          , Aa^Fpa      , Ha          
Gg          , Gg          , Gg          , Gg          , Gg          , Gg          , Hh          , Hh          , Mm          , Mm          , Hh          , Hh          , Ch          , Ch          , Ch          , Ch          , Gg          , Gg^Vh       , Rd          , Mm          , Rr          , Rr          , Hh^Fp       , Mm          , Rd          , Rd          , Mm          , Hh          , Ha          , Ha          , Aa          , Aa^Fpa      
Gg          , Gg          , Gg          , Gg          , Gs^Fp       , Hh          , Mm          , Mm          , Mm          , Mm          , Mm          , Hh          , Gs^Fp       , Ch          , Gg^Vh       , Ch          , Re^Gvs      , Wwf         , Rr          , Rr          , Mm          , Rr          , Rr          , Gs^Fp       , Mm          , Mm          , Mm          , Mm          , Mm          , Aa^Fpa      , Aa^Fpa      , Aa^Fpa      
Gg          , Gg          , Gg          , Gs^Fp       , Gs^Fp       , Hh^Fp       , Mm          , Mm          , Mm          , Mm          , Mm          , Mm          , Gs^Fp       , Gg          , Re^Gvs      , Re^Gvs      , Wwf         , Wwf         , Rr          , Gg^Vh       , Gs^Fp       , Mm          , Mm          , Rr          , Rr          , Mm          , Rr          , Mm^Vhh      , Hh          , Mm          , Mm          , Aa^Fpa      
Gg          , Gg          , Gg          , Gg          , Gg          , Hh          , Gs^Fp       , Mm          , Mm          , Mm          , Mm          , Gs^Fp       , Gs^Fp       , Re^Gvs      , Gg          , Gg^Vh       , Rr          , Ww^Bw/      , Ww          , Rr          , Rr          , Gs^Fp       , Gg^Vh       , Hh          , Mm          , Rr          , Hh          , Rr          , Rr          , Ch          , Rr          , Mm          
Gg          , Gg          , Gg          , Gg          , Gg          , Gs^Fp       , Mm          , Mm          , Mm          , Mm          , Hh          , Mm          , Chr         , Gs^Fp       , Rr          , Rr          , Wwf         , Ww          , Ww          , Ww          , Wwf         , Rr          , Rr          , Mm          , Mm          , Rr          , Chr         , Mm          , Mm          , Rr          , Rr          , Rr          
Rr          , Gg          , Gg          , Gg          , Gg          , Gs^Fp       , Hh^Fp       , Mm          , Hh^Vhh      , Gs^Fp       , Gg          , Hh          , Rr          , Rr          , Chr         , Gg          , Gg          , Gg^Vh       , Re^Gvs      , Re^Gvs      , Re^Gvs      , Gg^Vh       , Rr          , Mm          , Cud         , Chr         , 3 Kud       , Chr         , Mm          , Ch          , Mm          , Mm          
Gg          , Rr          , Rr          , Gg          , Gg          , Mm          , Mm          , Hh^Fp       , Gs^Fp       , Gg          , Rr          , Rr          , Hh          , Hh          , Mm          , Gg          , Gg^Wm       , Re^Gvs      , Re^Gvs      , Re^Gvs      , Re^Gvs      , Re^Gvs      , Rr          , Mm          , Mm          , Cud         , Cud         , Cud         , Mm          , Mm          , Mm          , Mm          
Gg          , Gg          , Gg          , Rr          , Rr          , Hh          , Rr          , Chr         , Rr          , Rr          , Rd          , Gs^Fp       , Gg^Vh       , Hh          , Rd          , Rd          , Gs^Fp       , Re^Gvs      , Re^Gvs      , Re^Gvs      , Re^Gvs      , Re^Gvs      , Rr          , Hh          , Mm          , Mm          , Hh^Fp       , Hh          , Mm          , Mm          , Mm          , Mm          
Gg          , Gg          , Gg          , Gg          , Gg          , Rr          , Gg          , Rr          , Mm          , Gs^Fp       , Gs^Fp       , Rd          , Rd          , Rd          , Gs^Fp       , Gs^Fp       , Gs^Fp       , Rd          , Gs^Fp       , Re^Gvs      , Re^Gvs      , Re^Gvs      , Rr          , Gg^Vh       , Gs^Fp       , Mm          , Gs^Fp       , Gs^Fp       , Gs^Fp       , Mm          , Ms          , Ms          
Gg          , Gg          , Gg          , Gg          , Gg          , Gg          , Gg          , Chr         , Mm          , Mm          , Mm          , Gs^Fp       , Rd          , Mm          , Mm          , Gs^Fp       , Gs^Fp       , Rd          , Rd          , Gs^Fp       , Hh          , Gg^Vh       , Gs^Fp       , Rr          , Mm          , Gs^Fp       , Gs^Fp       , Mm          , Mm          , Aa^Fpa      , Ms          , Ms          
Hh          , Hh          , Hh          , Gg          , Gs^Fp       , Gg          , Rd          , Mm          , Rd          , Gs^Fp       , Mm          , Rd          , Mm          , Hh          , Mm          , Mm          , Mm          , Mm          , Mm          , Rd          , Gs^Fp       , Mm          , Mm          , Rr          , Rr          , Mm          , Gs^Fp       , Gs^Fp       , Mm          , Mm          , Mm          , Ms          
Gs^Fp       , Gs^Fp       , Gs^Fp       , Hh          , Mm          , Gs^Fp       , Mm          , Rd          , Gs^Fp       , Rd          , Rd          , Rd          , Rd          , Rd          , Rd          , Mm          , Mm          , Mm          , Rd          , Rd          , Mm          , Hh          , Mm          , Mm          , Ch          , Rr          , Ch          , Mm          , Mm          , Mm          , Mm          , Mm          
Mm          , Gs^Fp       , Mm^Vhh      , Mm          , Mm^Xm       , Mm          , Mm          , Mm          , Mm          , Gs^Fp       , Hh          , Gs^Fp       , Mm^Vhh      , Gs^Fp       , Rd          , Gs^Fp       , Rd          , Gs^Fp       , Rd          , Mm          , Mm          , Mm          , Mm          , Mm          , Mm          , Rr          , Gs^Fp       , Mm          , Mm          , Mm^Vhh      , Mm          , Mm          
Mm          , Mm          , Mm^Xm       , Mm          , Mm^Xm       , Mm^Xm       , Mm^Xm       , Mm^Xm       , Mm^Xm       , Mm^Xm       , Mm^Xm       , Mm^Xm       , Mm^Xm       , Hh          , Gs^Fp       , Rd          , Gs^Fp       , Rd          , Rd          , Mm          , Mm          , Mm          , Mm          , Mm          , Gs^Fp       , Rr          , Rr          , Gs^Fp       , Gs^Fp       , Gs^Fp       , Gs^Fp       , Aa^Fpa      
Mm          , Mm          , Mm          , Mm^Xm       , Mm^Xm       , Mm^Xm       , Mm^Xm       , Mm^Xm       , Mm^Xm       , Mm^Xm       , Mm^Xm       , Mm^Xm       , Mm^Xm       , Mm^Xm       , Mm^Xm       , Gs^Fp       , Hh          , Hh          , Ggf         , Rd          , Hh          , Mm^Vhh      , Gs^Fp       , Gs^Fp       , Gs^Fp       , Gs^Fp       , Gg          , Rr          , Rr          , Gg          , Gg          , Gg          
Hh          , Mm          , Mm          , Mm          , Mm          , Mm^Xm       , Mm          , Mm          , Mm          , Mm^Xm       , Mm^Xm       , Mm^Xm       , Mm^Xm       , Mm^Xm       , Mm^Xm       , Mm          , Mm          , Hh          , Gs^Fp       , Rd          , Gs^Fp       , Gs^Fp       , Gs^Fp       , Gs^Fp       , Gg          , Gg          , Gg          , Gg          , Gg          , Rr          , Rr          , Gg          
Rr          , Hh          , Hh          , Mm          , Mm          , Mm          , Mm^Vhh      , Mm          , Mm          , Mm          , Mm^Xm       , Mm^Xm       , Mm^Xm       , Mm^Xm       , Mm          , Mm^Xm       , Mm          , Mm          , Gs^Fp       , Rd          , Rd          , Gs^Fp       , Gs^Fp       , Gs^Fp       , Gg          , Gg          , Gg          , Gg^Ve       , Gg          , Gg          , Gg          , Rr          
Hh          , Rr          , Rr          , Hh          , Hh          , Mm          , Hh          , Mm          , Mm          , Mm          , Mm          , Mm          , Mm          , Mm^Xm       , Mm          , Mm^Xm       , Mm          , Gs^Fp       , Gs^Fp       , Gs^Fp       , Gs^Fp       , Gs^Fp       , Gs^Fp       , Gs^Fp       , Gg          , Gg          , Gg          , Gg          , Ce          , Ce          , Gg          , Gg          
Mm          , Hh          , Hh          , Rr          , Rr          , Hh          , Hh          , Hh          , Hh          , Mm          , Mm          , Mm          , Mm          , Mm          , Mm          , Mm          , Mm          , Mm          , Mm^Vhh      , Gs^Fp       , Gs^Fp       , Gs^Fp       , Rd          , Rd          , Gs^Fp       , Gg          , Gg          , Gg          , Ce          , Ce          , Gg          , Gg          
Mm          , Mm          , Mm          , Hh          , Hh          , Rr          , Rr          , Hh          , Hh          , Mm          , Mm          , Mm          , Mm          , Mm          , Mm          , Mm          , Mm          , Mm          , Mm          , Ce          , Ce          , Ce          , Gs^Fp       , Gs^Fp       , Gs^Fp       , Gs^Fp       , Gg          , Gg          , Ce          , Ce          , Gg          , Gg          
Mm          , Mm          , Mm          , Mm          , Hh          , Hh          , Hh          , Rr          , Rr          , Mm          , Mm          , Mm^Xm       , Mm^Xm       , Mm^Vhh      , Mm          , Mm          , Gs^Fp       , Gs^Fp       , Ce          , Ce          , 1 Ke        , Ce          , Ce          , Gs^Fp       , Gs^Fp       , Gs^Fp       , Gs^Fp       , Gg          , Gg          , 2 Ke        , Gg          , Gg          
Mm          , Mm          , Mm          , Mm          , Hh          , Hh          , Hh          , Hh          , Rr          , Hh          , Hh          , Mm          , Mm^Xm       , Mm          , Mm          , Gs^Fp       , Gs^Fp       , Gs^Fp       , Gs^Fp       , Ce          , Gs^Fp       , Ce          , Gs^Fp       , Gs^Fp       , Gs^Fp       , Gs^Fp       , Gs^Fp       , Gg          , Gg          , Gg          , Gg          , Gg          
